AbilityBody	<color=FFFFFF><align=left><font=tahoma_regular_8>
AbilityBuffTemplate	{ability_affection}{ability_name}<br=2>[AbilityRecharge]Remaining: {ability_remain} {#digits_format (ability_remain) (digit_simple_format) (round, rounds, rounds)}<br=2>[AbilityRange]Range: {ability_range}<br=2>[AbilityText]{ability_text_description}{hotkey_info}
AbilityCooldownTemplate	{ability_affection}{ability_name}<br=2>[AbilityRecharge]Cooldown Time Remaining: {cooldown_remain_step} {#digits_format (cooldown_remain_step) (digit_simple_format) (round, rounds, rounds)}<br=2>[AbilityRange]Range: {ability_range}<br=2>[AbilityText]{ability_text_description}{hotkey_info}
AbilityEvil	<color=FF0000><align=center><font=tahoma_regular_10>
AbilityFriendTemplate	{ability_affection}{ability_name}<br=2>[AbilityText]{ability_text_description}
AbilityGood	<color=00FF00><align=center><font=tahoma_regular_10>
AbilityInstance	instantly
AbilityMaxDistance	max
AbilityName	<color=FFFF00><align=left><font=tahoma_bold_12>
AbilityNormalLimitedShotTemplate	{ability_affection}{ability_name}<br=2>[AbilityRecharge]Cooldown Time: {cooldown_base} {#digits_format (cooldown_base) (digit_simple_format) (round, rounds, rounds)}<br=2>[AbilityRange]Range: {ability_range}<br=2>[AbilityShotCountImg]Shot Count: {shot_count}<br=2>[AbilityText]{ability_text_description}{hotkey_info}
AbilityNormalRangeUnlimitedTemplate	{ability_affection}{ability_name}<br=2>[AbilityRecharge]Cooldown Time: {cooldown_base} {#digits_format (cooldown_base) (digit_simple_format) (round, rounds, rounds)}<br=2>[AbilityText]{ability_text_description}{hotkey_info}
AbilityNormalTemplate	{ability_affection}{ability_name}<br=2>[AbilityRecharge]Cooldown Time: {cooldown_base} {#digits_format (cooldown_base) (digit_simple_format) (round, rounds, rounds)}<br=2>[AbilityRange]Range: {ability_range}<br=2>[AbilityText]{ability_text_description}{hotkey_info}
AbilityParam	<color=FFFFFF><align=left><font=tahoma_regular_9>
AbilityPassiveTemplate	{ability_affection}{ability_name}<br=2>[AbilityText]{ability_text_description}{hotkey_info}
AbilityRange	<font=tahoma_regular_9><image=textures/interface/common/icons/arrow_target_16x16><indent=5><color=FFFFFF><align=left> 
AbilityRecharge	<font=tahoma_regular_9><image=textures/interface/common/icons/hourglass_16x16><indent=5><color=FFFFFF><align=left> 
AbilitySelfOnly	on self
AbilityShotCount	<font=tahoma_bold_10_border_smooth_numbers_only><color=FFFFFF><align=right>[?]
AbilityShotCountImg	<font=tahoma_regular_9><image=textures/interface/common/icons/shot_count_16x16><indent=5><color=FFFFFF><align=left>
AbilityText	<color=FFD42A><align=left><font=tahoma_regular_9>
CloseParam	</color>
SpellbookQuickScrollHotkey_Scroll1	F1
SpellbookQuickScrollHotkey_Scroll2	F2
SpellbookQuickScrollHotkey_Scroll3	F3
SpellbookQuickScrollHotkey_Scroll4	F4
SpellbookQuickScrollHotkey_Scroll5	F5
SpellbookQuickScrollHotkey_Scroll6	F6
SpellbookQuickScrollHotkeyInfo	<br><br><align=center><valign=center><font=tahoma_bold_8><color=FFFFFF>Spell Hotkey<color=36FF00>”[$]”</color>.
SpellbookQuickScrollHotkeyInfo_Tablets	<align=center><valign=center> 
UnitAbilityHotkey_Ability1	1
UnitAbilityHotkey_Ability2	2
UnitAbilityHotkey_Ability3	3
UnitAbilityHotkey_Ability4	4
UnitAbilityHotkey_Ability5	5
UnitAbilityHotkey_Ability6	6
UnitAbilityHotkey_Ability7	7
UnitAbilityHotkey_Ability8	8
UnitAbilityHotkey_Ability9	9
UnitAbilityHotkeyInfo	<br><br><align=center><valign=center><font=tahoma_bold_8><color=FFFFFF>Ability Hotkey <color=36FF00>"[$]"</color>
UnitAbilityHotkeyInfo_Tablets	<align=center><valign=center> 



